########################################
#                            *         #
#                            *         #
#                            *         #
#                                      #
######################                 #
#                                      #
#                                      #
#                              #########
#                                      #
#                                      #
#                     *                #
################      *                #
#              #      *                #
#              #      *                #
#              #      ##################
#              @                       #
#                                      #
#                                      #
########################################