########################################
#                                      #
#                                      #
#                                      #
#                                      #
######################                 #
#                                      #
#                                      #
#                              #########
#                                      #
#                                      #
#                                      #
################                       #
#              #                       #
#              #                       #
#              #      ##################
#              @                       #
#                                      #
#                                      #
########################################